.01437532.
..........
.B...BB..L
.BLL.BLL..
.B...B....
LLL..BJ...
....BLLLL.
....B.....
LL.LLLL...
..........
WWWGGWWGGW