.01437532.
..........
.B.B..B.B.
.BLL..LLB.
.B......B.
.B......B.
.B......B.
.B......B.
.B......B.
.B....J.B.
WGGGGGGGGW