.01437532.
..........
L.........
..........
..B.......
L.B.......
.LLL......
....BB....
LL.LLLL...
.....J....
GGWWWGGGGG