.01437532.
..........
..........
.B........
.B.B......
.B.B.B....
.B.B.B.B..
.B.B.BBB..
.B.BBBBB..
.BBBBBBBJ.
GGGGGGGGGG