.01437532.
..........
..........
.........L
.......BB.
......BLL.
...BLLB...
..JB..B...
LLBB..B...
..BB..B...
WWBBWWBWWW