.01437532.
..........
..........
..........
.......B..
L...B.BLL.
...BL.B...
..JB..B...
.BBB..B...
.BBB..B...
WGGBWWBGGW