.01437532.
....BB....
....BB....
...BBBB...
...BBBB...
..BBBBBB..
..BBBBBB..
..BBBBBB..
.BBBBBBBB.
..........
GGGGGGGGGG