.01437532.
..........
..........
..........
..........
..........
..........
.....J....
.B.B.B.B..
.B.B.B.B..
GGGGGGGGGW