......0...
..........
.B........
..B.......
...B......
..B....J..
B......BB.
.......BB.
.......BB.
.......BB
WWWWWWWWWW