.01437532.
..........
..B...B...
..LL..LL..
..........
..........
.....B..B.
...JBB..B.
LL.LLLL.LL
..........
WWWWWWWWWW