.01437532.
.........L
..B.......
..LL......
.......B..
.LL....LL.
..........
....JB....
...LLLL...
..........
WWWWWWWWWW