.01437532.
..........
.B......B.
.BB....BB.
.BB....BB.
LBB.J..BBL
LLLLBBLLLL
....BB....
....BB....
....BB....
WWWWBBWWWW