.01437532.
..........
..........
..........
..........
..........
...B..B...
...B.JB...
LL.LLLL.LL
..........
WWWWWWWWWW