.03770535.
..........
..........
..........
.BBB.B....
.BB..B.LLL
.B........
..........
........LL
.....BB.J.
GGGGWGGGGG