3245356761
..........
LLLL..LLLL
000B..B000
...B..B...
LLLL..LLLL
.BBBB.BBB.
.BBB..BBB.
...B.JBBB.
..B..BBB..
WWWGGGGWGG