.01437532.
..........
.B..BB..B.
.BLLBBLLB.
.B..BB..B.
.B..BB..B.
.B..BB..B.
.B..BB..B.
.B..BB..B.
.B.JBB..B.
WGGGGGGWGW