.01437532.
..........
.BBBBBBBB.
..........
...BBBB...
.LLBBBBLL.
...BBBB...
...BBBB...
...BBBB...
.......J..
WGGGGGGGGW