.01437532.
..........
..........
..........
..........
L........L
....BB....
...BBBB...
..BLLLLB..
.BB....BBJ
GGGWWWWGGG