.07437532.
..........
LB........
.BB.......
.BBB......
.BBBB.....
.BBBBB....
.BBBBBB...
LLBBBBBB..
..BBBBBBBJ
GGGGGGGGGG
