.01437532.
..........
..........
..........
..........
.BB....B..
.LLB...LL.
...B.JB...
...BBBB...
...LLLL...
GGGWWWWWWW