.00763451.
..........
..........
..........
..BBB.....
..BBB.....
.LLLL.....
..........
LL......LL
....J.....
GGGGGWWWWW