.01437532.
....BB....
....BB....
...BBBB...
..JBBBB...
..BBBBBB..
..BBBBBB..
..BBBBBB..
.BBBBBBBB.
..........
GGGGGGGGGG