.01012131.
..........
.B..B.N.B.
.BLLB.LLB.
.B..B...B.
.B..B...B.
.B..B...B.
.B..B...B.
.B..B...B.
.B..BJ..B.
WGGGGGGGGW