...000000.
..........
..........
..........
..........
..........
..........
..........
..........
.JB......B
GGGGGGGGGG