0000000000
.LLLLLLLL.
00000000B0
.LLLLLLLLL
000B000000
..LLLLLLLL
.BB.......
.LLLLL....
B..B......
B..BJ.....
GGGGGGGGGG