.01437532.
..........
..........
..........
..........
.......B.L
....LL.B..
.B.B...B..
LL.B...B..
...BJ..B..
GGGGGGGGGG