.29005016.
..........
.B......B.
.B......B.
.BB....BB.
.BB...JBB.
.BBB..BBB.
.BBB..BBB.
LLBBBBBBLL
..BBBBBB..
GGGGGGGGGG