.01437532.
..........
..........
..........
.....J....
...BBBBB..
...BBBBB..
...BBBBB..
...BBBBB..
...BBBBB..
GGGGGGGGWW