.01437532.
..........
.BBBBBBBB.
.BBBBBBBB.
.BBBLLBBB.
.BBB..BBB.
.BBB..BBB.
.BBB..BBB.
.BBB..BBB.
.BBB.JBBB.
WGGGGGGGGW