.11220304.
..........
..........
....B.....
....LL....
..........
....LL....
...B......
...LLLL...
.......J..
WWWGGGGGGG