....000...
..........
..........
..........
..........
..........
..........
..........
..........
..JB...B..
GGGGGGGGGG