2222222222
11111LLLLL
00.BB.....
...LL.....
B.........
...B..BJ..
.BBB..BBB.
.BBBBBBBB.
.LLL..BBB.
......BBB
WWWWWWWWWW