450340017.
..........
L.........
..........
.B.BLLB...
.B.B..B...
.B.B..B...
.B.B..B...
.B.B..B.LL
.BBBJ.B...
GGGGGGGGGG