.01437532.
..........
..........
..........
..........
....BB....
....BB....
...BBBB...
..BBBBBB..
JBBBBBBBB.
GGGGGGGGGG