.01437532.
........B.
..........
..LL....B.
..........
........B.
....BJ....
....BB..B.
LL.LLLL.LL
..........
WWWWWWWWWW