.24356000.
..........
..B...B...
.LL..LL...
....B.....
....B...B.
.LLLB.LLL.
....B.....
...LLLL.LL
.......J..
WWWWWWWGWW